11111
1A  1
1 1 1
1B  1
11111
